##..###...#...##
#.##..#...###.##
###...#.#.##..#.
.###..#.#.#####.
##...##....#....
#.#.##.#....#..#
#..###.##..#..##
..##.###..###..#
###.######.#..#.
.#.##.#..##.#.##
..###..####..##.
#.#...#........#
#...##..#.##..##
...#..######.###
#.#.#.##########
.###..#.##..#..#
